21 81
+++++++++++++++++++++++++++++++++++++++++++++++++++++++++++++++++++++++++++++++++
+i                                                                              +
+ +++ + +++ +++ +++ +++++++++++ +++ +++ + +++ +++++++++ + +++++ +++++ + + + +   +
+     + +     + +   + +       +       + + +   +     +   + +     +   + + +   +   +
+ +++++ + +++++ + +++ + +++++ +++++++++ + + +++ +++ +++ +++ +++++ + + + +++++++ +
+       + + +   +   + + +   + +         + +   + + +   +   +       + +   + +     +
+ +++++ + + + +++++ + + +++ + + +++++++ + +++ + + +++ +++ +++++++++ +++++ + +++ +
+       + + +       + +   +     + +     + + +       + + +   +   +   +     + +   +
+ +++++ + + +++++++++ +++ +++++++ + +++++ + +++++++++ + +++ + + + +++ + + + + + +
+     +++ +         +   +   + +   + +   + +     +   + +   +   + +   + + + + + + +
+ +++ + + + +++ +++ +++ +++ + + + + +++ + + + +++ + + + +++++++ +++ + + +++ +++ +
+ +   +   + + + +       +   + + + +     + + +   + +   + +   +   +   + +   +     +
+ + +++++++ + + +++++++++ +++ + + +++++ + +++++ + +++++ + + + +++ +++ +++ +++++ +
+ + +         + +         +     +     + +     + +   + +   +   +   + +   +       +
+ + + +++++++++ + +++++++ +++++++ + +++ +++++ + +++ + + +++++++++ + +++ +++++++ +
+ + +   +   +   + +       +     + +       +   +   + + +   +       +     +     + +
+ + +++++ + + + + +++++++++ +++ +++++++++ + +++ +++ + +++ +++ +++++ +++++ +++ + +
+   +     + + + +         +   + +       + +   +   + +         +   +     +   + + +
+ o++ +++++ + + +++++++++ +++ + + +++++ +++++ +++ + +++++++++++ + +++++ +++ + + +
+                                                                               +
+++++++++++++++++++++++++++++++++++++++++++++++++++++++++++++++++++++++++++++++++

